NO ./assets/textures/xpm/New-Project.xpm
SO ./assets/textures/xpm/wall_2.xpm
WE ./assets/textures/xpm/wall_3.xpm
EA ./assets/textures/xpm/wall_4.xpm

F 0,0,0
C 255,10,50

111111111111111111111111111111111111111111111111111111111111111111111111111111111111111111111111111111111111111111111111111111
100000000000000000000001111111111111111111111111111111111111111111111111111111111111111111111111111111111111111111111111111111
100000000000000000000001111111111111111111111111111111111111111111111111111111111111111111111111111111111111111111111111111111
100000000000000000000001111111111111111111111111111111111111111111111111111111111111111111111111111111111111111111111111111111
100000111110000101010001111111111111111111111111111111111111111111111111111111111111111111111111111111111111111111111111111111
100000100010000000000001111111111111111111111111111111111111111111111111111111111111111111111111111111111111111111111111111111
100000100010000100010001111111111111111111111111111111111111111111111111111111111111111111111111111111111111111111111111111111
100000100010000000000001111111111111111111111111111111111111111111111111111111111111111111111111111111111111111111111111111111
100000110110000101010001111111111111111111111111111111111111111111111111111111111111111111111111111111111111111111111111111111
100000000000000000000001111111111111111111111111111111111111111111111111111111111111111111111111111111111111111111111111111111
100000000000000000000001111111111111111111111111111111111111111111111111111111111111111111111111111111111111111111111111111111
100000000000000000000001111111111111111111111111111111111111111111111111111111111111111111111111111111111111111111111111111111
100000000000000000000001111111111111111111111111111111111111111111111111111111111111111111111111111111111111111111111111111111
100000000000000000N00001111111111111111111111111111111111111111111111111111111111111111111111111111111111111111111111111111111
100000000000000000000001111111111111111111111111111111111111111111111111111111111111111111111111111111111111111111111111111111
100000000000000000000001111111111111111111111111111111111111111111111111111111111111111111111111111111111111111111111111111111
111111111000000000000001111111111111111111111111111111111111111111111111111111111111111111111111111111111111111111111111111111
110100001000000000000001111111111111111111111111111111111111111111111111111111111111111111111111111111111111111111111111111111
110000101000000000000001111111111111111111111111111111111111111111111111111111111111111111111111111111111111111111111111111111
110100001000000000000001111111111111111111111111111111111111111111111111111111111111111111111111111111111111111111111111111111
110111111000000000000001111111111111111111111111111111111111111111111111111111111111111111111111111111111111111111111111111111
110000000000000000000000000000000000000000000000000000000000000000000000000000000000000000000000000000000000000000000000000011
111111111000000000000001111111111111111111111111111111111111111111111111111111111111111111111111111111111111111111111111111111
111111111111111111111111111111111111111111111111111111111111111111111111111111111111111111111111111111111111111111111111111111